--------------
--------------
-cBBYBPDcBBYB-
----L------L--
-Yc-BBBYBBEBE-
-L-----L------
-EBBYBBcBYEBc-
----L----L----
-BYBBEBYBEBEc-
--L----L------
-MBBB-cBBBcEB-
--------------
--------------
